[方案]
方案名称=zsm
 
[零声母标识]
=O
 
[声母]
# 双拼编码就是它本身的声母不必列出
ch=I
sh=U
zh=V
 
[韵母]
# 双拼编码就是它本身的韵母不必列出
ai=D
an=N
ang=Y
ao=C
ei=W
en=T
eng=G
er=R
ia=X
ian=M
iang=L
iao=B
ie=H
in=P
ing=F
iong=S
iu=Q
ong=S
ou=Z
ua=X
uai=F
uan=R
uang=L
ue=K
ui=V
un=J
uo=O
